##########
#E     pb#
#       C#
# CpP    #
# ggg    #
# OOO    #
#        #
#        #
#        #
##########

