OOOOOOOOOO
O#########
O#XX X C #
O##g C   #
O##%%#####
O#  C m  #
O#       #
O#  E   b#
O#########
OOOOOOOOOO

