#########O
#       #O
# CE## t#O
# CC   X#O
### ## X#O
###    X#O
#b  p#  #O
#   t####O
######OOOO
OOOOOOOOOO

