OOOOOOOOOO
OOOOOOOOOO
##########
# m   % X#
#     %CX#
#E   C%  #
######%CX#
OOOOOO####
OOOOOOOOOO
OOOOOOOOOO
