OOOOOOOOOO
OO###OOOOO
OO#X#OOOOO
OO# #OOOOO
OO#C#####O
OO#EggCX#O
OO#C#####O
OO#X#OOOOO
OO###OOOOO
OOOOOOOOOO
