##########
#E    XgO#
#C C CggO#
#gggggggO#
#ggg gggO#
#gggggggO#
#gOg gggO#
#gPO gggO#
#XgXggggO#
##########

