OOOOOOOOOO
O#########
O#  ggOgg#
O#E CgOgX#
O#    P  #
O#  C    #
O#  C   X#
O#       #
O#  X    #
O#########


