OOOOOOOOOO
O#########
O#E C O  #
O#       #
O#  p C  #
O#    p  #
O#  P O  #
O#       #
O#########
OOOOOOOOOO

