##########
#b  X   X#
#        #
# mgC    #
# %g     #
#  g   # #
#  C   #C#
#     O# #
#  X   #E#
##########
